#+#+$++++#
+#++#+###+
a+###++#++
+#++#+b+#+
#+c+#+++##
++#+##++++
##+#+##+++
++++#+#+##
++#++##+#+
#####+++#+
